NO textures/snow.png
SO textures/snow.png
WE textures/snow.png
EA textures/snow.png

F 255,255,255
C 135,206,235

11111111111111111111111111111111111111111
11111100000000000000000000000000000111111
11111000000000000000000000000000000011111
11110000011111111111011111111111000001111
11100000000000000000000000000000000000111
11000000000000000000000000000000000000011
10000000000000000000000000000000000000001
10000000000000000000000000000000000000001
1000000000000S000000000000000000000000001
11000000000000000000000000000000000000011
10000000000000000000000000000000000000001
10000000000000000000000000000000000000001
10000000000001111100000111110000000000001
10000000011111111110001111111111000000001
11000000000111111110001111111100000000011
10000000000011111110001111111000000000001
10000000000011111110001111111000000000001
10000000000011111110001111111000000000001
10000000000001111100000111110000000000001
10000000000000000000000000000000000000001
11111100000000000000000000000000000111111
10000000000000000000000000000000000000001
10000000000001111100000111110000000000001
10000000000011111110001111111000000000001
10000000000011111110001111111000000000001
10000000000011111110001111111000000000001
11000000000111111110001111111100000000011
10000000011111111110001111111111000000001
10000000000001111100000111110000000000001
10000000000000000000000000000000000000001
10000000000000000000000000000000000000001
10000000000000000000000000000000000000001
11000000000000000000000000000000000000011
10000000000000000000000000000000000000001
10000000000000000000000000000000000000001
10000000000000000000000000000000000000001
11000000000000000000000000000000000000011
11100000000000000000000000000000000000111
11110000011111111111011111111111000001111
11111000000000000000000000000000000011111
11111100000000000000000000000000000111111
11111111111111111111111111111111111111111
