NO textures/north.png
SO textures/SO.xpm
WE textures/WE.xpm
EA textures/EA.xpm

F 220,100,0
C 225,30,0

11111111111111111111111111111
10000000000000000000000000001
10000000000000000000000000001
10000000000111111100000000001
10000000001100000110000000001
10000000011000N00001100000001
10000000011000000011000000001
10000000011000000011000000001
10000000011000000011000000001
10000000001100000110000000001
10000000000111011100000000001
10000000000000000000000000001
10000111111111011111111000001
10000100000000000000001000001
10000100000000000000001000001
10000100000000000000001000001
10000100000111111000001000001
10000100001000001000001000001
10000100010000000100001000001
10000100010000000100001000001
10000100010000000100001000001
10000100010000000100001000001
10000100001000001000001000001
10000100000111111000001000001
10000100000000000000001000001
10000100000000000000001000001
10000111111111111111111000001
10000000000000000000000000001
10000000000000000000000000001
11111111111111111111111111111
