
NO ./textures/north.png
SO ./textures/south.png
WE ./textures/west.png
EA ./textures/east.png

F 51,0,120
C 12,12,118

        1111111111111111111111111
        1000000000110000000000001
        1011000001110000000000001
        1001000000000000000000001
111111111011000001110000000000001
100000000011000001110111111111111
11110111111111011100000010001
111101111111101110101001111101
11000000110101011100000010001
10000000000000001100000010001
100000000000000011010100S0001
1100000111010101111101000000111111
11110111 1110101 10111101000000001
11111111 1111111 11111111111111111
