NO textures/north.png
SO textures/south.png
WE textures/west.png
EA textures/east.png

F 220,100,0
C 225,30,0

11111111111111111111111111111
10100000000000000000000000001
11000000000000000000000000001
10000000000111111111000000001
10000000001100000011000000001
10000000001000N00001000000001
10000000001100000011000000001
10000000000111101111000000001
10000000000000000000000000001
10000000000000000000000000001
10000000001111111111000000001
10000000001000000001000000001
10000000001000000001000000001
10000000001000000001000000001
10000000001000000001000000001
10000000001111000111100000001
10000000000001000100000000001
10000000000001000100000000001
10000000000001000100000000001
10000000011111000111110000001
10000000010000000000010000001
10000000010000000000010000001
10000000010000000000010000001
10000000011111111111110000001
10000000000000000000000000001
10000000000000000000000000001
11111111111111111111111111111