NO textures/maze.png
SO textures/maze.png
WE textures/maze.png
EA textures/maze.png

F 0,0,0
C 0,0,0

1111111111111111111111111111111111111111111
1000000000000000000000000000000000000000001
1011111011111111111011111110111111101111101
1010001010000000010100000010100000101000101
1010111010111111010111111010111110101110101
1010100010100000010000001010000010100000101
1010111110111111111011101010111110111111101
1010000000000000001000101010100000000000101
1010111110111111111110101010111111111110101
1010100000100000000000101010000000000010101
1010101110101111111110101011111110111010101
1010101010101000000010101010000010101010101
1010101011101011111010101010111010101010101
1010001000001010001010101010100010101010101
1010111011101010101010101010111010101010101
1010100000101010101010101010001010101010101
1010101110101010101010101010111010101010101
1010101000101010101010001010000010101010101
1010111010111010101110111110111110111010101
1010000010000000100000000000000010000010101
1011111110111110111110111111111110111011111
1000000000100000100000100000000000100000001
1011111110111110101010101111111010111111101
1010000000000000101010100000001010000000101
1010111110111111101010111111101011111110101
1010000010100000001010100000101000000010101
1011111010101111101010101110101110111010101
1000000010101000101000101010000010001010101
1011111010111010101110101010111110101110101
1010000010000000100000101010000010000000101
1010111111111110111111101110111111111111101
10100000000000000000000000000000000000000E1
1111111111111111111111111111111111111111111
